1011111111
1012221111
1121111211
0011111111
1111111111
1111111111
1111100011
1111101011
1111100011
1111111111