1011111111
1011111111
1111111111
0011111111
1111111111
1111111111
1111100011
1111101011
1111100011
1111111111